border_size=1
usage=map

Xos, Xos, Xos, Xos, Xos, Xos, Xos, Xos, Xos, Xos, Xos, Xos, Xos, Xos, Xos, Xos, Xos, Xos, Xos, Xos, Xos, Xos, Xos, Xos, Xos, Xos, Xos, Xu, Xu, Xu, Xu, Xu, Xu, Xu, Xu, Xu, Xu, Xu, Xu, Xu, Xu, Xu, Xu, Xu, Xu, Xu, Xu, Xu, Xu, Xu, Xu, Xu
Xos, Xos, Xos, Xos, Xos, Xos, Xos, Xos, Xos, Xos, Xos, Xos, Xos, Xos, Xos, Xos, Xos, Xos, Xos, Xos, Xos, Xos, Xos, Xos, Xos, Xos, Xos, Xu, Xu, Xu, Xu, Xu, Xu, Xu, Xu, Xu, Xu, Xu, Xu, Xu, Xu, Xu, Xu, Xu, Xu, Xu, Xu, Xu, Xu, Xu, Xu, Xu
Xos, Xos, Xos, Xos, Xos, Xos, Xos, Xos, Xos, Xos, Xos, Xos, Xos, Xos, Xos, Xos, Xos, Xos, Xos, Xos, Xos, Xos, Xos, Xos, Xos, Xos, Xos, Xu, Xu, Xu, Xu, Xu, Xu, Xu, Xu, Xu, Xu, Xu, Xu, Xu, Xu, Xu, Xu, Xu, Xu, Xu, Xu, Xu, Xu, Xu, Xu, Xu
Xos, Xos, Xos, Xos, Xos, Xos, Xos, Xos, Xos, Xos, Xos, Xos, Xos, Xos, Xos, Xos, Xos, Xos, Xos, Xos, Xos, Xos, Xos, Xos, Xos, Xos, Xu, Xu, Xu, Xu, Uu^Vu, Xu, Xu, Xu, Xu, Xu, Uu, Uu, Uu, Xu, Xu, Xu, Uu, Uu, Uu, Xu, Uu, Xu, Xu, Xu, Xu, Xu
Xos, Xos, Xos, Xos, Xos, Xos, Xos, Xos, Xos, Xos, Xos, Xos, Xos, Xos, Xos, Xos, Xos, Xos, Xos, Xos, Xos, Xos, Xos, Xos, Xu, Xu, Xu, Xu, Xu, Xu, Xu, Uu, Uu, Xu, Xu, Re, Xu, Uu, Xu, Uu, Xu, Xu, Xu, Xu, Re, Uu, Uu, Xu, Uh, Uh, Xu, Xu
Xos, Xos, Xos, Xos, Xos, Xos, Xos, Xos, Xos, Xos, Xos, Xos, Xos, Xos, Xos, Xos, Xos, Xos, Xos, Xos, Xos, Xos, Xu, Xu, Xu, Xu, Xu, Xu, Xu, Xu, Xu, Uu, Xu, Xu, Uu, Uu, Uu, Xu, Uh, Xu, Xu, Xu, Xu, Re, Xu, Xu, Uu, Uu, Xu, Xu, Xu, Xu
Xos, Xos, Xos, Xos, Xos, Xos, Xol, Xol, Uu, Xol, Xol, Xos, Xos, Xos, Xos, Xos, Xos, Xos, Xos, Xos, Xu, Xu, Xu, Xu, Xu, Xu, Xu, Xu, Xu, Xu, Xu, Uu, Uh, Uh, Xu, Xu, Xu, Uh, Xu, Uu, Uu, Uu, Uh, Uu, Uu, Xu, Xu, Uu, Xu, Xu, Xu, Xu
Xos, Xos, Xos, Xos, Xos, Xol, Uu, Uu, Uu, Uu, Uu, Xos, Xol, Xos, Xos, Xos, Xos, Xos, Xos, Xu, Xu, Xu, Xu, Xu, Xu, Uu^Uf, Uu^Uf, Xu, Xu, Xu, Uu, Xu, Xu, Uh, Xu, Xu, Xu, Xu, Rd, Uu, Xu, Uu, Uh, Uh, Uh, Xu, Rd, Uu, Uu, Xu, Xu, Xu
Xos, Xos, Xos, Xos, Xos, Uu, Uu, Uu, Uu, Rd, Rd, Uu, Uu, Xol, Xos, Xos, Xos, Xos, Xu, Xu, Xu, Xu, Xu, Xu, Uu^Uf, Uu^Uf, Xu, Xu, Xu, Xu, Xu, Uu, Xu, Xu, Uu, Xu, Uu, Uu, Uu, Xu, Uu, Uu, Uu, Xu, Xu, Xu, Re, Rd, Xu, Uu, Xu, Xu
Xos, Xos, Xos, Xos, Xos, Uu, Uu, Uu, Ce, Uu, Uu, Uu, Uu, Xol, Xos, Xos, Xos, Xos, Xu, Xu, Xu, Xu, Uu^Uf, Xu, Uu, Xu, Xu, Xu, Xu, Xu, Xu, Rd, Rd, Uu, Xu, Uu, Xu, Uu, Xu, Xu, Rd, Rd, Xu, Xu, Uu, Xu, Xu, Rd, Uu, Xu, Xu, Xu
Xos, Xos, Xos, Xos, Xos, Uu, Uu, Ce, 2 Ke, Ce, Uu, Uu, Uu, Uu, Xos, Xos, Xos, Xos, Xu, Xu, Xu, Uu^Uf, Uu, Uu, Xu, Xu, Xu, Xu, Xu, Xu, Xu, Uu, Xu, Uh, Xu, Xu, Xu, Uu, Uh, Uh, Uu, Xu, Uu, Xu, Uu, Xu, Xu, Uu, Xu, Xu, Xu, Xu
Xos, Xos, Xos, Xos, Xos, Uu, Uu, Ce, Ce, Ce, Uu, Uu, Uu, Uu, Xos, Xos, Xos, Xu, Xu, Xu, Xu, Uu, 5 Uu, Uu^Vu, Uu^Uf, Xu, Xu, Xu, Uh, Uh, Xu, Uu, Xu, Uu, Xu, Xu, Uu, Uu, Xu, Uh, Uu, Uu, Xu, Uu, Uh, Uh, Xu, Uu, Uh, Uh, Xu, Xu
Xos, Xos, Xos, Xos, Xos, Uu, Uu, Uu, Uu, Uu, Re, Uu, Uu, Uu, Xos, Xos, Xos, Xu, Xu, Xu, Uu, Uu, Uu, Re, Re, Xu, Xu, Xu, Uh, Xu, Uu, Uu, Xu, Xu, Uu, Uu, Xu, Xu, Xu, Xu, Re, Xu, Xu, Xu, Xu, Uh, Xu, Xu, Xu, Xu, Xu, Xu
Xos, Xos, Xos, Xos, Xos, Uu, Re, Uu, Rd, Uu, Uu, Uu, Xos, Xos, Xos, Xos, Xu, Xu, Xu, Uu^Vu, Rd, Uu, Uu^Vu, Uu, Uu, Xu, Xu, Xu, Xu, Uu, Xu, Xu, Xu, Xu, Re, Xu, Xu, Xu, Uu, Xu, Rd, Xu, Xu, Xu, Xu, Xu, Xu, Xu, Xu, Xu, Xu, Xu
Xos, Xos, Xos, Xos, Xos, Uu, Re, Uu, Re, Uu, Xol, Xos, Xos, Xos, Xos, Xu, Xu, Xu, Xu, Uu, Rd, Uu, Xu, Xu, Uu, Uu, Xu, Xu, Xu, Xu, Xu, Xu, Xu, Xu, Re, Xu, Uh, Xu, Xu, Uu, Uu, Uu, Uu, Xu, Uu, Xu, Xu, Xu, Xu, Xu, Xu, Xu
Xos, Xos, Xos, Xos, Xos, Uu, Uu, Uu, Uu, Rd, Rd^Zse, Xol, Xos, Xos, Xos, Xu, Xu, Xu, Xu, Xu, Rd, Xu, Xu, Xu, Xu, Xu, Xu, Xu, Xu, Xu, Xu, Uu, Uu, Uu, Xu, Xu, Uh, Uu, Xu, Xu, Xu, Xu, Xu, Uu, Uu, Uu, Uu, Xu, Xu, Xu, Xu, Xu
Xos, Xos, Xos, Xos, Xos, Xos, Xos, Uu, Xos, Xos, Xos, Re, Re, Uu, Uu, Xos, Xu, Xu, Uu, Re, Xu, Xu, Xu, Xu, Xu, Xu, Xu, Xu, Xu, Xu, Uh, Rd, Uu, Xu, Uu, Uh, Xu, Uu, Xu, Xu, Uu, Uu^Vu, Uu, Xu, Xu, Xu, Xu, Uu, Xu, Xu, Xu, Xu
Xos, Xos, Xos, Xos, Xos, Xos, Xos, Xos, Xos, Xos, Xos, Xos, Xos, Uu, Uu, Qxu, Qxu, Uu, Xu, Xu, Xu, Xu, Xos, Xos, Xos, Xu, Xu, Xu, Xu, Xu, Uh, Xu, Xu, Uu, Xu, Xu, Xu, Uu, Xu, Xu, Xu, Xu, Re, Xu, Xu, Xu, Xu, Xu, Xu, Xu, Xu, Xu
Xos, Xos, Xos, Xos, Xos, Xos, Xos, Xos, Xos, Xos, Xos, Xos, Xos, Uu, Re, Qxu^Bp/, Qxu, Xu, Xu, Xu, Xu, Xos, Xos, Xos, Xos, Xos, Xu, Xu, Uu, Uh, Xu, Xu, Xu, Xu, Xu, Xu, Xu, Uu, Uh, Uh, Uu, Xu, Uu, Uu, Xu, Xu, Xu, Xu, Xu, Xu, Xu, Xu
Xos, Xos, Xos, Xos, Xos, Xos, Xos, Xos, Xos, Xos, Xu, Xos, Xos, Uu, Uu, Uu, Xos, Xu, Xu, Xu, Xos, Xos, Xos, Xos, Uu, Uu, Uu^Br/, Uu, Re, Xu, Xu, Xu, Xu, Xu, Xu, Xu, Xu, Xu, Xu, Xu, Xu, Uu, Xu, Uu, Xu, Xu, Xu, Xu, Xu, Xu, Xu, Xu
Xos, Xos, Xos, Xos, Xos, Xos, Xos, Xos, Xu, Xu, Xu, Xu, Xos, Re, Uu, Xos, Xos, Xu, Xos, Xos, Xos, Xos, Uu, Uu, Rd^Br/, Uu^Br/, Rd, Uu, Uu, Ur, Uu^Zse, Xu, Xu, Xu, Xu, Xu, Xu, Xu, Uh, Xu, Xu, Xu, Xu, Xu, Xu, Xu, Xu, Xu, Xu, Xu, Xu, Xu
Xos, Xos, Xos, Xos, Xos, Xos, Xos, Xu, Xos, Xu, Xu, Xu, Rd, Re, Uu, Xos, Xos, Xos, Xos, Xos, Uu, Uu, Uu^Br/, Rd^Br/, Xu, Xu, Uu, Uu, Xos, Xu, Xu, Ur, Re, Xu, Uu, Xu, Xu, Uu, Uu, Xu, Xu, Xu, Xu, Xu, Xu, Xu, Xu, Xu, Xu, Xu, Xu, Xu
Uu^Ii, Uu, Uu, Xos, Uu^Vud, Xos, Uu, Xos, Uu, Xu, Re, Uu, Uu, Uu, Uu, Xos, Xos, Xos, Uu, Re, Re^Br/, Uu^Br/, Xos, Uu, Re, Re, Xos, Xos, Xu, Xu, Xu, Xu, Xu, Re, Xu, Xu, Xu, Xu, Uu, Xu, Uu, Xu, Uu, Xu, Re, Xu, Uu, Xu, Xu, Xu, Xu, Xu
Uu^Ii, Ce, 1 Ke, Uu, Ce, Uu, Uu, Uu, Rd, Uu, Uu, Rd, Uu, Qxu, Uu, Uu, Uu, Uu, Uu^Br/, Uu^Br/, Xos, Xos, Xos, Xos, Xos, Xos, Xos, Xos, Xu, Xu, Xu, Xu, Xu, Uh, Uh, Uu, Uu, Uu, Xu, Rd, Xu, Xu, Uh, Uu, Xu, Re, Xu, Uu, Xu, Xu, Xu, Xu
Uu^Ii, Ce, Ce, Ce, Ce, Re, Uu, Rd, Uu, Uu, Uu, Uu, Re, Qxu, Uu, Re, Uu^Br/, Uu^Br/, Xos, Xos, Xos, Xos, Xos, Xos, Xos, Xos, Xos, Xos, Xu, Xu, Xu, Xu, Xu, Uu, Uu, Xu, Xu, Uu, Re, Xu, Xu, Uu, Xu, Xu, Xu, Xu, Xu, Xu, Xu, Xu, Xu, Xu
Xos, Uu, Xos, Uu, Xos, Xos, Xos, Xos, Xos, Xos, Xos, Uu, Uu, Uu, Uu^Br/, Uu^Br/, Uu, Rd, Uu, Uu, Rd, Xos, Xos, Xos, Xos, Xos, Xos, Xos, Xos, Xu, Xu, Xu, Xu, Xu, Xu, Xu, Xu, Uu, Xu, Uu, Uu, Uu, Xu, Xu, Xu, Xu, Xu, Xu, Uh, Uh, Xu, Xu
Xos, Xos, Xos, Xos, Xos, Xos, Xos, Xos, Xol, Xos, Uu, Uu, Uu^Br/, Uu^Br/, Xol, Xos, Xos, Xos, Xos, Xos, Xos, Rd, Uu, Xos, Xos, Xos, Xol, Xos, Xos, Xos, Xos, Xu, Xu, Xu, Xu, Xu, Xu, Uh, Xu, Xu, Rd, Xu, Uu, Rd, Uu, Uh, Uu, Uu, Xu, Uu, Xu, Xu
Xos, Xos, Xos, Xos, Xos, Xos, Xos, Xol, Uu, Uu, Uu^Br/, Uu^Br/, Xol, Xol, Rd, Rd, Rd, Rd, Xos, Xos, Uu, Uu, Uu, Uu, Uu, Rd, Uu, Xol, Xos, Xos, Xos, Xos, Xu, Xu, Xu, Xu, Uu, Uh, Xu, Xu, Rd, Uu, Uu, Xu, Xu, Uu, Xu, Uu, Xu, Xu, Xu, Xu
Xos, Xos, Xos, Xos, Xol, Xol, Uu, Uu, Uu^Br/, Uu^Br/, Xos, Xos, Rd, Rd, Rd, Rd, Rd, Rd, Xos, Uu, Ce, Ce, Ce, Xos, Xos, Rd, Uu, Uu, Uu, Xos, Xos, Xos, Xos, Xu, Xu, Xu, Uu, Xu, Xu, Xu, Uu, Xu, Xu, Uu, Uu, Xu, Xu, Uu, Uu, Xu, Xu, Xu
Xos, Xos, Xol, Uu^Vud, Uu, Uu, Uu^Br/, Uu^Br/, Xos, Xos, Xos, Xos, Xos, Rd, Xos, Xos, Xos, Rd, Rd, Xos, Uu^Zsw, 3 Ke, Xos, Xos, Xos, Xos, Xos, Xos, Uu, Xos, Xos, Xos, Xos, Xu, Xu, Xu, Xu, Xu, Xu, Xu, Uh, Uh, Xu, Xu, Xu, Xu, Xu, Xu, Uu, Xu, Xu, Xu
Xos, Xol, Uu, Uu, Uu^Br/, Uu^Br/, Xos, Xos, Xos, Xos, Re^Vd, Re, Re, Xos, Re^Vd, Re, Re, Xos, Rd, Rd, Rd, Xos, Re, Re, Re, Xos, Xos, Xos, Uu, Uu, Xos, Xos, Xos, Xos, Xos, Xu, Xu, Xu, Xu, Xu, Xu, Xu, Xu, Xu, Xu, Xu, Xu, Uu, Xu, Xu, Xu, Xu
Uu^Ii, Uu^Zsw, Uu^Zsw, Uu^Br/, Xos, Xos, Xos, Xos, Xos, Xos, Re, Re, Re, Xos, Re, Re, Re, Xos, Xos, Rd, Xos, Xos, Re, Re, Re, Xos, Xos, Uu, Xos, Re, Xos, Xos, Xos, Xos, Xos, Xu, Xu, Xu, Xu, Xu, Xu, Xu, Xu, Xu, Xu, Xu, Xu, Xu, Xu, Xu, Xu, Xu
Uu^Br/, Uu^Br/, Xos, Xos, Xos, Xos, Xos, Xos, Xos, Xos, Xos, Re, Uu, Xos, Uu, Re, Uu, Xos, Uu, Xos, Uu, Xos, Uu, Re, Uu, Xos, Qxu, Xos, Xos, Uu, Xos, Xos, Xos, Xos, Xos, Xu, Xu, Xu, Xu, Xu, Xu, Xu, Xu, Xu, Xu, Xu, Xu, Xu, Xu, Xu, Xu, Xu
Xos, Xos, Xos, Xos, Xos, Xos, Xos, Xos, Xos, Xos, Xos, Xos, Xos, Uu, Xos, Xos, Xos, Uu, Uu, Uu, Uu, Uu, Xos, Xos, Xos, Uu, Qxu, Uu^Vu, Uu, Uu, Xos, Xos, Xos, Xos, Xos, Xos, Xos, Xu, Xos, Xu, Xos, Xu, Xu, Xu, Xu, Xu, Xu, Xu, Xos, Xos, Xos, Xos
Xos, Xos, Xos, Xos, Xos, Xos, Xos, Xos, Xos, Xos, Xos, Xos, Uu, Uu, Uu, Xos, Uu, Uu, Uu, Uu, Uu, Uu, Uu, Xos, Uu, Uu, Uu, Uu, Xos, Xos, Xos, Xos, Xos, Xos, Xos, Xos, Xos, Xos, Xos, Xos, Xos, Xos, Xos, Xu, Xu, Xu, Xos, Xos, Xos, Xos, Xos, Xos
Xos, Xos, Xos, Xos, Xos, Xos, Xos, Xos, Xos, Xos, Re, Re, Re, Xos, Re, Re, Re, Xos, Xos, Xos, Xos, Xos, Re, Re, Re, Xos, Xos, Xos, Xos, Xos, Xos, Xos, Xos, Xos, Xos, Xos, Xos, Xos, Xos, Xos, Xos, Xos, Xos, Xos, Xos, Xos, Xos, Xos, Xos, Xos, Xos, Xos
Xos, Xos, Xos, Xos, Xos, Xos, Xos, Xos, Xos, Xos, Re^Vd, Re, Re, Xos, Re^Vd, Re, Re, Xos, Xos, Xos, Xos, Xos, Re, Re, Re, Xos, Xos, Xos, Xos, Xos, Xos, Xos, Xos, Xos, Xos, Xos, Xos, Xos, Xos, Xos, Xos, Xos, Xos, Xos, Xos, Xos, Xos, Xos, Xos, Xos, Xos, Xos
Xos, Xos, Xos, Xos, Xos, Xos, Xos, Xos, Xos, Xos, Xos, Re, Xos, Xos, Xos, Re, Xos, Xos, Xos, Xos, Xos, Xos, Xos, Re, Xos, Xos, Xos, Xos, Xos, Xos, Xos, Xos, Xos, Xos, Xos, Xos, Xos, Xos, Xos, Xos, Xos, Xos, Xos, Xos, Xos, Xos, Xos, Xos, Xos, Xos, Xos, Xos
Xos, Xos, Xos, Xos, Xos, Xos, Xos, Xos, Xos, Xos, Xos, Xos, Xos, Xos, Xos, Xos, Xos, Xos, Xos, Xos, Xos, Xos, Xos, Xos, Xos, Xos, Xos, Xos, Xos, Xos, Xos, Xos, Xos, Xos, Xos, Xos, Xos, Xos, Xos, Xos, Xos, Xos, Xos, Xos, Xos, Xos, Xos, Xos, Xos, Xos, Xos, Xos
Xos, Xos, Xos, Xos, Xos, Xos, Xos, Xos, Xos, Xos, Xos, Xos, Xos, Xos, Xos, Xos, Xos, Xos, Xos, Xos, Xos, Xos, Xos, Xos, Xos, Xos, Xos, Xos, Xos, Xos, Xos, Xos, Xos, Xos, Xos, Xos, Xos, Xos, Xos, Xos, Xos, Xos, Xos, Xos, Xos, Xos, Xos, Xos, Xos, Xos, Xos, Xos
Xos, Xos, Xos, Xos, Xos, Xos, Xos, Xos, Xos, Xos, Xos, Xos, Xos, Xos, Xos, Xos, Xos, Xos, Xos, Xos, Xos, Xos, Xos, Xos, Xos, Xos, Xos, Xos, Xos, Xos, Xos, Xos, Xos, Xos, Xos, Xos, Xos, Xos, Xos, Xos, Xos, Xos, Xos, Xos, Xos, Xos, Xos, Xos, Xos, Xos, Xos, Xos
Xos, Xos, Xos, Xos, Xos, Xos, Xos, Xos, Xos, Xos, Xos, Xos, Xos, Xos, Xos, Xos, Xos, Xos, Xos, Xos, Xos, Xos, Xos, Xos, Xos, Xos, Xos, Xos, Xos, Xos, Xos, Xos, Xos, Xos, Xos, Xos, Xos, Xos, Xos, Xos, Xos, Xos, Xos, Xos, Xos, Xos, Xos, Xos, Xos, Xos, Xos, Xos
